//MAP CONVERTED BY dmm2tgm.py THIS HEADER COMMENT PREVENTS RECONVERSION, DO NOT REMOVE
"a" = (
/turf/simulated/floor/plating/asteroid/basalt/lava_land_surface,
/area/lavaland/surface/outdoors/unexplored)
"b" = (
/turf/simulated/wall/mineral/iron,
/area/ruin/powered/lavaland)
"c" = (
/turf/simulated/floor/plating/asteroid/basalt/lava_land_surface,
/area/ruin/powered/lavaland)
"d" = (
/obj/structure/railing{
	dir = 8
	},
/turf/simulated/floor/plating/asteroid/basalt/lava_land_surface,
/area/ruin/powered/lavaland)
"e" = (
/obj/structure/stone_tile/burnt,
/obj/effect/mapping_helpers/no_lava,
/turf/simulated/floor/plating/asteroid/basalt/lava_land_surface,
/area/lavaland/surface/outdoors/unexplored)
"f" = (
/obj/structure/stone_tile{
	dir = 1
	},
/obj/structure/stone_tile/cracked{
	dir = 8
	},
/obj/effect/mapping_helpers/no_lava,
/turf/simulated/floor/plating/asteroid/basalt/lava_land_surface,
/area/lavaland/surface/outdoors/unexplored)
"g" = (
/obj/structure/fluff/grave,
/turf/simulated/floor/plating/asteroid/basalt/lava_land_surface,
/area/ruin/powered/lavaland)
"h" = (
/obj/structure/railing{
	dir = 6
	},
/turf/simulated/floor/plating/asteroid/basalt/lava_land_surface,
/area/ruin/powered/lavaland)
"j" = (
/obj/structure/railing{
	dir = 4
	},
/turf/simulated/floor/plating/asteroid/basalt/lava_land_surface,
/area/ruin/powered/lavaland)
"k" = (
/obj/structure/stone_tile,
/obj/effect/mapping_helpers/no_lava,
/turf/simulated/floor/plating/asteroid/basalt/lava_land_surface,
/area/lavaland/surface/outdoors/unexplored)
"l" = (
/obj/structure/stone_tile{
	dir = 8
	},
/obj/structure/stone_tile/block{
	dir = 1
	},
/obj/effect/mapping_helpers/no_lava,
/turf/simulated/floor/plating/asteroid/basalt/lava_land_surface,
/area/lavaland/surface/outdoors/unexplored)
"m" = (
/obj/structure/stone_tile,
/obj/structure/stone_tile/cracked{
	dir = 1
	},
/obj/structure/stone_tile/block{
	dir = 8
	},
/turf/simulated/floor/plating/asteroid/basalt/lava_land_surface,
/area/ruin/powered/lavaland)
"o" = (
/obj/structure/stone_tile{
	dir = 1
	},
/obj/effect/mapping_helpers/no_lava,
/turf/simulated/floor/plating/asteroid/basalt/lava_land_surface,
/area/lavaland/surface/outdoors/unexplored)
"q" = (
/obj/structure/stone_tile,
/obj/structure/stone_tile{
	dir = 8
	},
/obj/structure/stone_tile/cracked{
	dir = 1
	},
/turf/simulated/floor/plating/asteroid/basalt/lava_land_surface,
/area/ruin/powered/lavaland)
"r" = (
/obj/structure/stone_tile,
/obj/structure/stone_tile{
	dir = 8
	},
/obj/structure/stone_tile/block{
	dir = 1
	},
/turf/simulated/floor/plating/asteroid/basalt/lava_land_surface,
/area/ruin/powered/lavaland)
"s" = (
/obj/structure/stone_tile/block{
	dir = 8
	},
/obj/structure/stone_tile/block/cracked{
	dir = 4
	},
/turf/simulated/floor/plating/asteroid/basalt/lava_land_surface,
/area/ruin/powered/lavaland)
"t" = (
/turf/template_noop,
/area/template_noop)
"u" = (
/obj/structure/stone_tile/block{
	dir = 4
	},
/turf/simulated/floor/plating/asteroid/basalt/lava_land_surface,
/area/ruin/powered/lavaland)
"x" = (
/obj/structure/stone_tile,
/obj/structure/stone_tile/block{
	dir = 1
	},
/turf/simulated/floor/plating/asteroid/basalt/lava_land_surface,
/area/ruin/powered/lavaland)
"B" = (
/obj/structure/stone_tile{
	dir = 4
	},
/obj/effect/mapping_helpers/no_lava,
/turf/simulated/floor/plating/asteroid/basalt/lava_land_surface,
/area/lavaland/surface/outdoors/unexplored)
"H" = (
/obj/structure/stone_tile{
	dir = 4
	},
/obj/structure/stone_tile{
	dir = 1
	},
/obj/structure/stone_tile/burnt,
/turf/simulated/floor/plating/asteroid/basalt/lava_land_surface,
/area/ruin/powered/lavaland)
"I" = (
/obj/structure/stone_tile/block{
	dir = 1
	},
/turf/simulated/floor/plating/asteroid/basalt/lava_land_surface,
/area/ruin/powered/lavaland)
"K" = (
/obj/structure/stone_tile/slab/cracked,
/obj/effect/baseturf_helper/lava_land/surface,
/turf/simulated/floor/plating/asteroid/basalt/lava_land_surface,
/area/ruin/powered/lavaland)
"M" = (
/obj/structure/stone_tile{
	dir = 8
	},
/obj/structure/stone_tile/block{
	dir = 4
	},
/turf/simulated/floor/plating/asteroid/basalt/lava_land_surface,
/area/ruin/powered/lavaland)
"N" = (
/obj/effect/mapping_helpers/no_lava,
/turf/simulated/floor/plating/asteroid/basalt/lava_land_surface,
/area/lavaland/surface/outdoors/unexplored)
"O" = (
/obj/structure/stone_tile/block{
	dir = 4
	},
/obj/structure/stone_tile/block/cracked{
	dir = 8
	},
/obj/effect/mapping_helpers/no_lava,
/turf/simulated/floor/plating/asteroid/basalt/lava_land_surface,
/area/lavaland/surface/outdoors/unexplored)
"Q" = (
/obj/structure/stone_tile/block/cracked{
	dir = 4
	},
/obj/structure/stone_tile{
	dir = 8
	},
/turf/simulated/floor/plating/asteroid/basalt/lava_land_surface,
/area/ruin/powered/lavaland)
"S" = (
/obj/structure/stone_tile/block{
	dir = 4
	},
/obj/effect/mapping_helpers/no_lava,
/turf/simulated/floor/plating/asteroid/basalt/lava_land_surface,
/area/lavaland/surface/outdoors/unexplored)
"T" = (
/obj/structure/stone_tile{
	dir = 4
	},
/obj/structure/stone_tile/cracked,
/turf/simulated/floor/plating/asteroid/basalt/lava_land_surface,
/area/ruin/powered/lavaland)
"U" = (
/obj/structure/katana_grave/basalt,
/turf/simulated/floor/plating/asteroid/basalt/lava_land_surface,
/area/ruin/powered/lavaland)
"W" = (
/obj/structure/flora/rock/pile,
/obj/effect/mapping_helpers/no_lava,
/turf/simulated/floor/plating/asteroid/basalt/lava_land_surface,
/area/lavaland/surface/outdoors/unexplored)
"X" = (
/obj/structure/railing{
	dir = 10
	},
/turf/simulated/floor/plating/asteroid/basalt/lava_land_surface,
/area/ruin/powered/lavaland)
"Y" = (
/obj/structure/stone_tile{
	dir = 4
	},
/obj/structure/stone_tile/block{
	dir = 4
	},
/turf/simulated/floor/plating/asteroid/basalt/lava_land_surface,
/area/ruin/powered/lavaland)

(1,1,1) = {"
t
t
t
t
t
t
t
k
N
t
t
t
t
t
t
"}
(2,1,1) = {"
t
t
t
N
t
t
N
B
N
t
t
t
t
t
t
"}
(3,1,1) = {"
t
t
b
N
b
b
b
O
b
b
b
b
b
t
t
"}
(4,1,1) = {"
t
t
b
c
c
c
c
r
c
c
c
c
N
N
t
"}
(5,1,1) = {"
t
t
b
c
g
c
c
m
c
g
c
c
b
N
t
"}
(6,1,1) = {"
t
t
b
c
c
c
g
Y
c
c
c
c
b
N
N
"}
(7,1,1) = {"
t
t
b
d
d
X
c
Q
c
c
g
c
W
N
N
"}
(8,1,1) = {"
t
t
b
c
U
c
I
K
H
s
q
u
l
f
B
"}
(9,1,1) = {"
t
t
b
j
j
h
c
Y
c
g
c
c
N
N
N
"}
(10,1,1) = {"
t
t
b
c
c
c
c
T
c
c
c
c
b
N
t
"}
(11,1,1) = {"
t
N
W
c
g
c
c
x
g
c
g
c
b
t
t
"}
(12,1,1) = {"
t
t
b
c
c
c
c
M
c
c
c
c
b
t
t
"}
(13,1,1) = {"
t
t
b
b
b
b
b
S
b
b
b
N
b
a
t
"}
(14,1,1) = {"
t
t
t
t
t
t
N
e
N
t
t
N
t
a
t
"}
(15,1,1) = {"
t
t
t
t
t
t
N
o
t
t
t
t
t
t
t
"}
