//MAP CONVERTED BY dmm2tgm.py THIS HEADER COMMENT PREVENTS RECONVERSION, DO NOT REMOVE
"a" = (
/turf/simulated/floor/indestructible/yellow_light,
/area/deathmatch/fullbright)
"n" = (
/turf/simulated/floor/indestructible/green_light,
/area/deathmatch/fullbright)
"r" = (
/turf/simulated/floor/indestructible/green_circuit,
/area/deathmatch/fullbright)
"B" = (
/turf/simulated/floor/indestructible/abductor_vault,
/area/deathmatch/fullbright)
"E" = (
/turf/template_noop,
/area/template_noop)
"G" = (
/turf/simulated/wall/indestructible/titanium,
/area/deathmatch/fullbright)
"H" = (
/obj/effect/landmark/deathmatch_player_spawn,
/turf/simulated/floor/indestructible/abductor_vault,
/area/deathmatch/fullbright)
"L" = (
/turf/simulated/wall/indestructible/abductor/normal,
/area/deathmatch/fullbright)
"W" = (
/obj/machinery/door/airlock/titanium/glass,
/turf/simulated/floor/indestructible/abductor,
/area/deathmatch/fullbright)

(1,1,1) = {"
E
E
L
L
L
L
L
L
L
L
L
L
L
L
L
L
L
L
L
L
L
L
L
L
E
E
"}
(2,1,1) = {"
E
L
L
B
B
B
B
B
B
B
W
n
n
n
n
W
B
B
B
B
B
B
B
L
L
E
"}
(3,1,1) = {"
L
L
B
B
B
B
B
B
B
B
W
n
n
n
n
W
B
B
B
B
B
B
B
B
L
L
"}
(4,1,1) = {"
L
B
B
H
B
G
G
B
B
B
G
n
n
n
n
G
B
B
B
G
G
B
H
B
B
L
"}
(5,1,1) = {"
L
B
B
B
B
B
B
B
B
B
B
G
n
n
G
B
B
B
B
B
B
B
B
B
B
L
"}
(6,1,1) = {"
L
B
B
G
B
B
B
B
B
B
B
B
G
G
B
B
B
B
B
B
B
B
G
B
B
L
"}
(7,1,1) = {"
L
B
B
G
B
B
B
B
G
B
B
B
B
B
B
B
B
G
B
B
B
B
G
B
B
L
"}
(8,1,1) = {"
L
B
B
B
B
B
B
G
B
B
r
r
r
r
r
r
B
B
G
B
B
B
B
B
B
L
"}
(9,1,1) = {"
L
B
B
B
B
B
G
B
H
r
r
G
W
W
G
r
r
H
B
G
B
B
B
B
B
L
"}
(10,1,1) = {"
L
B
B
B
B
B
B
B
r
r
G
a
a
a
a
G
r
r
B
B
B
B
B
B
B
L
"}
(11,1,1) = {"
L
W
W
G
B
B
B
r
r
G
a
a
a
a
a
a
G
r
r
B
B
B
G
W
W
L
"}
(12,1,1) = {"
L
n
n
n
G
B
B
r
G
a
a
a
a
a
a
a
a
G
r
B
B
G
n
n
n
L
"}
(13,1,1) = {"
L
n
n
n
n
G
B
r
W
a
a
a
a
a
a
a
a
W
r
B
G
n
n
n
n
L
"}
(14,1,1) = {"
L
n
n
n
n
G
B
r
W
a
a
a
a
a
a
a
a
W
r
B
G
n
n
n
n
L
"}
(15,1,1) = {"
L
n
n
n
G
B
B
r
G
a
a
a
a
a
a
a
a
G
r
B
B
G
n
n
n
L
"}
(16,1,1) = {"
L
W
W
G
B
B
B
r
r
G
a
a
a
a
a
a
G
r
r
B
B
B
G
W
W
L
"}
(17,1,1) = {"
L
B
B
B
B
B
B
B
r
r
G
a
a
a
a
G
r
r
B
B
B
B
B
B
B
L
"}
(18,1,1) = {"
L
B
B
B
B
B
G
B
H
r
r
G
W
W
G
r
r
H
B
G
B
B
B
B
B
L
"}
(19,1,1) = {"
L
B
B
B
B
B
B
G
B
B
r
r
r
r
r
r
B
B
G
B
B
B
B
B
B
L
"}
(20,1,1) = {"
L
B
B
G
B
B
B
B
G
B
B
B
B
B
B
B
B
G
B
B
B
B
G
B
B
L
"}
(21,1,1) = {"
L
B
B
G
B
B
B
B
B
B
B
B
G
G
B
B
B
B
B
B
B
B
G
B
B
L
"}
(22,1,1) = {"
L
B
B
B
B
B
B
B
B
B
B
G
n
n
G
B
B
B
B
B
B
B
B
B
B
L
"}
(23,1,1) = {"
L
B
B
H
B
G
G
B
B
B
G
n
n
n
n
G
B
B
B
G
G
B
H
B
B
L
"}
(24,1,1) = {"
L
L
B
B
B
B
B
B
B
B
W
n
n
n
n
W
B
B
B
B
B
B
B
B
L
L
"}
(25,1,1) = {"
E
L
L
B
B
B
B
B
B
B
W
n
n
n
n
W
B
B
B
B
B
B
B
L
L
E
"}
(26,1,1) = {"
E
E
L
L
L
L
L
L
L
L
L
L
L
L
L
L
L
L
L
L
L
L
L
L
E
E
"}
