//MAP CONVERTED BY dmm2tgm.py THIS HEADER COMMENT PREVENTS RECONVERSION, DO NOT REMOVE
"a" = (
/turf/simulated/floor/chasm/straight_down/lava_land_surface/normal_air,
/area/deathmatch/fullbright)
"b" = (
/obj/structure/railing,
/turf/simulated/floor/indestructible/asteroid,
/area/deathmatch/fullbright)
"c" = (
/obj/structure/railing{
	dir = 1
	},
/obj/structure/flora/ausbushes/sparsegrass/hell,
/turf/simulated/floor/indestructible/asteroid,
/area/deathmatch/fullbright)
"e" = (
/obj/structure/railing,
/obj/structure/flora/ausbushes/fullgrass/hell,
/turf/simulated/floor/indestructible/asteroid,
/area/deathmatch/fullbright)
"g" = (
/obj/structure/railing{
	dir = 1
	},
/obj/structure/flora/ausbushes/fullgrass/hell,
/turf/simulated/floor/indestructible/asteroid,
/area/deathmatch/fullbright)
"i" = (
/obj/structure/railing{
	dir = 4
	},
/turf/simulated/floor/indestructible/asteroid,
/area/deathmatch/fullbright)
"j" = (
/obj/structure/railing,
/obj/structure/flora/ausbushes/fernybush/hell,
/turf/simulated/floor/indestructible/asteroid,
/area/deathmatch/fullbright)
"l" = (
/turf/simulated/wall/indestructible/mineral_rock,
/area/deathmatch/fullbright)
"o" = (
/obj/structure/railing{
	dir = 8
	},
/obj/structure/flora/ausbushes/hell,
/turf/simulated/floor/indestructible/asteroid,
/area/deathmatch/fullbright)
"p" = (
/obj/structure/railing{
	dir = 4
	},
/obj/structure/flora/ausbushes/sparsegrass/hell,
/turf/simulated/floor/indestructible/asteroid,
/area/deathmatch/fullbright)
"q" = (
/obj/structure/railing{
	dir = 4
	},
/obj/structure/flora/ausbushes/ywflowers/hell,
/turf/simulated/floor/indestructible/asteroid,
/area/deathmatch/fullbright)
"r" = (
/obj/structure/railing/corner{
	dir = 8
	},
/obj/structure/flora/firebush,
/turf/simulated/floor/indestructible/asteroid,
/area/deathmatch/fullbright)
"s" = (
/obj/structure/railing,
/obj/structure/flora/ausbushes/grassybush/hell,
/turf/simulated/floor/indestructible/asteroid,
/area/deathmatch/fullbright)
"w" = (
/obj/structure/railing/corner{
	dir = 1
	},
/obj/structure/flora/ausbushes/fullgrass/hell,
/turf/simulated/floor/indestructible/asteroid,
/area/deathmatch/fullbright)
"y" = (
/turf/simulated/floor/indestructible/asteroid,
/area/deathmatch/fullbright)
"A" = (
/obj/effect/landmark/deathmatch_player_spawn,
/turf/simulated/floor/indestructible/stone_floor,
/area/deathmatch/fullbright)
"D" = (
/obj/structure/railing{
	dir = 4
	},
/obj/structure/flora/ausbushes/grassybush/hell,
/turf/simulated/floor/indestructible/asteroid,
/area/deathmatch/fullbright)
"E" = (
/obj/structure/railing{
	dir = 8
	},
/obj/structure/flora/ausbushes/fullgrass/hell,
/turf/simulated/floor/indestructible/asteroid,
/area/deathmatch/fullbright)
"G" = (
/obj/structure/railing{
	dir = 1
	},
/obj/structure/flora/ausbushes/fernybush/hell,
/turf/simulated/floor/indestructible/asteroid,
/area/deathmatch/fullbright)
"H" = (
/obj/structure/railing,
/obj/structure/flora/firebush,
/turf/simulated/floor/indestructible/asteroid,
/area/deathmatch/fullbright)
"I" = (
/turf/simulated/floor/indestructible/stone_floor,
/area/deathmatch/fullbright)
"J" = (
/obj/structure/flora/ausbushes/ywflowers/hell,
/turf/simulated/floor/indestructible/asteroid,
/area/deathmatch/fullbright)
"K" = (
/obj/structure/railing{
	dir = 1
	},
/obj/structure/flora/ausbushes/hell,
/turf/simulated/floor/indestructible/asteroid,
/area/deathmatch/fullbright)
"L" = (
/obj/structure/railing/corner,
/turf/simulated/floor/indestructible/asteroid,
/area/deathmatch/fullbright)
"O" = (
/obj/structure/flora/ausbushes/sparsegrass/hell,
/turf/simulated/floor/indestructible/asteroid,
/area/deathmatch/fullbright)
"P" = (
/obj/structure/flora/ausbushes/fullgrass/hell,
/turf/simulated/floor/indestructible/asteroid,
/area/deathmatch/fullbright)
"S" = (
/obj/structure/flora/ausbushes/fernybush/hell,
/turf/simulated/floor/indestructible/asteroid,
/area/deathmatch/fullbright)
"V" = (
/obj/structure/railing{
	dir = 8
	},
/obj/structure/flora/ausbushes/grassybush/hell,
/turf/simulated/floor/indestructible/asteroid,
/area/deathmatch/fullbright)
"W" = (
/obj/structure/railing{
	dir = 8
	},
/obj/structure/flora/ausbushes/sparsegrass/hell,
/turf/simulated/floor/indestructible/asteroid,
/area/deathmatch/fullbright)
"X" = (
/obj/structure/flora/ausbushes/hell,
/turf/simulated/floor/indestructible/asteroid,
/area/deathmatch/fullbright)

(1,1,1) = {"
l
l
l
l
l
l
l
l
l
l
l
l
l
l
l
l
l
l
l
l
l
l
l
l
l
"}
(2,1,1) = {"
l
l
J
y
y
l
l
l
l
l
l
l
l
l
l
l
l
l
l
l
l
l
l
l
l
"}
(3,1,1) = {"
l
y
y
X
y
y
l
l
l
l
l
l
l
l
l
l
l
l
l
l
l
l
l
l
l
"}
(4,1,1) = {"
l
y
y
J
L
p
p
i
q
D
l
l
l
l
l
l
l
l
l
l
l
l
l
l
l
"}
(5,1,1) = {"
l
l
y
y
H
a
a
a
a
a
a
l
l
l
l
l
l
l
l
a
l
l
l
l
l
"}
(6,1,1) = {"
l
l
l
O
b
a
I
I
a
a
a
a
a
a
a
a
a
a
a
a
K
l
l
l
l
"}
(7,1,1) = {"
l
l
l
l
l
a
a
I
I
I
I
I
a
I
I
a
I
I
I
a
g
l
l
l
l
"}
(8,1,1) = {"
l
l
l
l
b
a
a
I
A
I
a
I
A
I
I
a
I
A
I
a
K
J
l
l
l
"}
(9,1,1) = {"
l
l
y
X
e
a
a
I
a
I
I
I
I
I
a
I
I
I
I
a
g
y
l
l
l
"}
(10,1,1) = {"
l
l
l
y
j
a
a
I
a
I
I
a
I
I
I
I
I
a
I
a
K
S
l
l
l
"}
(11,1,1) = {"
l
l
l
O
b
a
a
I
I
I
I
I
A
I
a
a
I
I
I
a
G
l
l
l
l
"}
(12,1,1) = {"
l
l
l
y
H
a
a
I
I
a
I
I
I
I
I
I
I
I
a
a
l
l
l
l
l
"}
(13,1,1) = {"
l
l
l
l
s
a
a
I
I
I
I
a
I
a
I
A
I
I
a
a
l
l
l
l
l
"}
(14,1,1) = {"
l
l
l
l
l
a
a
I
A
I
I
I
I
I
I
I
I
I
a
l
l
l
l
l
l
"}
(15,1,1) = {"
l
l
l
l
l
l
a
I
I
I
a
I
a
I
I
a
I
I
a
l
l
l
l
l
l
"}
(16,1,1) = {"
l
l
l
l
l
l
l
a
I
I
I
I
I
I
I
I
I
I
a
l
l
l
l
l
l
"}
(17,1,1) = {"
l
l
l
l
l
l
a
I
A
I
I
A
I
I
a
I
A
a
a
l
l
l
l
l
l
"}
(18,1,1) = {"
l
l
l
l
l
a
a
a
I
I
I
I
I
I
I
I
I
I
a
l
l
l
l
l
l
"}
(19,1,1) = {"
l
l
l
l
a
a
a
a
I
I
a
I
a
a
a
I
a
I
a
a
l
l
l
l
l
"}
(20,1,1) = {"
l
l
l
l
a
a
I
I
I
a
a
a
a
a
a
a
a
I
I
a
g
l
l
l
l
"}
(21,1,1) = {"
l
l
l
b
a
a
a
a
a
a
l
l
l
l
l
l
a
a
a
a
c
y
P
l
l
"}
(22,1,1) = {"
l
l
l
r
E
E
V
l
l
l
l
l
l
l
l
l
l
E
W
o
w
S
l
l
l
"}
(23,1,1) = {"
l
l
l
l
y
S
l
l
l
l
l
l
l
l
l
l
l
l
y
y
l
l
l
l
l
"}
(24,1,1) = {"
l
l
l
l
l
l
l
l
l
l
l
l
l
l
l
l
l
l
l
l
l
l
l
l
l
"}
(25,1,1) = {"
l
l
l
l
l
l
l
l
l
l
l
l
l
l
l
l
l
l
l
l
l
l
l
l
l
"}
