//MAP CONVERTED BY dmm2tgm.py THIS HEADER COMMENT PREVENTS RECONVERSION, DO NOT REMOVE
"a" = (
/obj/effect/decal/cleanable/dust,
/obj/effect/spawner/random/trash,
/turf/simulated/floor/indestructible/plating,
/area/deathmatch)
"b" = (
/obj/effect/landmark/deathmatch_player_spawn,
/obj/effect/decal/cleanable/dust,
/turf/simulated/floor/indestructible/plating,
/area/deathmatch)
"f" = (
/obj/effect/decal/cleanable/dust,
/obj/structure/window/reinforced,
/obj/structure/window/reinforced{
	dir = 4
	},
/obj/structure/grille,
/turf/simulated/floor/indestructible/plating,
/area/deathmatch)
"i" = (
/obj/effect/decal/cleanable/dust,
/obj/structure/window/reinforced,
/obj/structure/grille,
/obj/structure/window/reinforced{
	dir = 1
	},
/turf/simulated/floor/indestructible/plating,
/area/deathmatch)
"j" = (
/obj/effect/decal/cleanable/blood/tracks{
	dir = 4
	},
/turf/simulated/floor/indestructible/plating,
/area/deathmatch)
"k" = (
/turf/simulated/wall/indestructible/reinforced,
/area/deathmatch)
"m" = (
/obj/effect/decal/cleanable/dust,
/turf/simulated/floor/indestructible/plating,
/area/deathmatch)
"n" = (
/obj/item/storage/toolbox/mechanical/old,
/obj/effect/decal/cleanable/dust,
/turf/simulated/floor/indestructible/plating,
/area/deathmatch)
"o" = (
/obj/effect/decal/cleanable/dust,
/obj/effect/decal/cleanable/blood/tracks,
/turf/simulated/floor/indestructible/plating,
/area/deathmatch)
"p" = (
/obj/effect/decal/cleanable/dust,
/obj/effect/landmark/deathmatch_player_spawn,
/turf/simulated/floor/indestructible/plating,
/area/deathmatch)
"r" = (
/obj/effect/decal/cleanable/dust,
/obj/structure/window/reinforced,
/obj/structure/window/reinforced{
	dir = 8
	},
/obj/structure/grille,
/turf/simulated/floor/indestructible/plating,
/area/deathmatch)
"s" = (
/obj/effect/decal/cleanable/dust,
/obj/structure/window/reinforced{
	dir = 1
	},
/obj/structure/grille,
/obj/structure/window/reinforced{
	dir = 8
	},
/turf/simulated/floor/indestructible/plating,
/area/deathmatch)
"t" = (
/obj/effect/decal/cleanable/dust,
/obj/item/twohanded/spear,
/turf/simulated/floor/indestructible/plating,
/area/deathmatch)
"u" = (
/obj/structure/chair/comfy/shuttle{
	dir = 4
	},
/obj/item/twohanded/cardboard_cutout/adaptive{
	icon_state = "cutout_ntsec";
	dir = 4
	},
/obj/effect/decal/cleanable/dust,
/turf/simulated/floor/indestructible/plating,
/area/deathmatch)
"w" = (
/obj/item/clothing/mask/gas,
/obj/effect/decal/cleanable/dust,
/turf/simulated/floor/indestructible/plating,
/area/deathmatch)
"y" = (
/obj/effect/decal/cleanable/dust,
/obj/item/melee/baseball_bat,
/turf/simulated/floor/indestructible/plating,
/area/deathmatch)
"B" = (
/obj/effect/decal/cleanable/dust,
/obj/effect/decal/cleanable/blood/tracks{
	dir = 4
	},
/turf/simulated/floor/indestructible/plating,
/area/deathmatch)
"E" = (
/obj/effect/decal/cleanable/dust,
/obj/structure/window/reinforced{
	dir = 1
	},
/obj/structure/grille,
/obj/structure/window/reinforced,
/turf/simulated/floor/indestructible/plating,
/area/deathmatch)
"F" = (
/obj/structure/window/reinforced{
	dir = 4
	},
/obj/structure/grille,
/obj/structure/window/reinforced{
	dir = 8
	},
/turf/simulated/floor/indestructible/plating,
/area/deathmatch)
"G" = (
/obj/structure/chair/comfy/shuttle{
	dir = 8
	},
/obj/item/twohanded/cardboard_cutout/adaptive{
	icon_state = "cutout_ntsec";
	dir = 8
	},
/obj/effect/decal/cleanable/dust,
/turf/simulated/floor/indestructible/plating,
/area/deathmatch)
"I" = (
/obj/structure/window/reinforced{
	dir = 1
	},
/obj/structure/grille,
/obj/structure/window/reinforced{
	dir = 4
	},
/turf/simulated/floor/indestructible/plating,
/area/deathmatch)
"K" = (
/obj/structure/window/reinforced{
	dir = 8
	},
/obj/structure/grille,
/obj/structure/window/reinforced{
	dir = 4
	},
/turf/simulated/floor/indestructible/plating,
/area/deathmatch)
"L" = (
/turf/simulated/floor/indestructible/plating,
/area/deathmatch)
"M" = (
/obj/effect/spawner/random/trash,
/turf/simulated/floor/indestructible/plating,
/area/deathmatch)
"R" = (
/turf/simulated/wall/indestructible/fakedoor,
/area/deathmatch)
"T" = (
/obj/effect/decal/cleanable/dust,
/obj/item/flashlight/flare/on,
/turf/simulated/floor/indestructible/plating,
/area/deathmatch)
"U" = (
/obj/effect/decal/cleanable/dust,
/obj/effect/decal/cleanable/blood,
/turf/simulated/floor/indestructible/plating,
/area/deathmatch)
"X" = (
/obj/effect/decal/cleanable/dust,
/obj/effect/decal/cleanable/blood/tracks,
/obj/effect/decal/cleanable/blood/tracks{
	dir = 8
	},
/turf/simulated/floor/indestructible/plating,
/area/deathmatch)
"Z" = (
/obj/item/flashlight/flare/on,
/turf/simulated/floor/indestructible/plating,
/area/deathmatch)

(1,1,1) = {"
k
k
k
k
k
k
R
k
R
k
k
k
k
k
k
"}
(2,1,1) = {"
k
L
m
m
m
m
w
m
m
m
a
m
m
L
k
"}
(3,1,1) = {"
k
L
L
u
u
u
u
u
u
u
u
u
L
L
k
"}
(4,1,1) = {"
k
m
s
K
K
K
K
K
K
K
K
K
r
m
k
"}
(5,1,1) = {"
k
t
E
L
m
m
m
U
o
X
m
L
i
n
k
"}
(6,1,1) = {"
k
m
E
L
m
T
m
b
m
B
m
L
i
m
k
"}
(7,1,1) = {"
R
m
E
L
a
m
m
m
m
j
m
Z
i
t
R
"}
(8,1,1) = {"
k
a
E
L
m
m
m
y
m
m
m
L
i
m
k
"}
(9,1,1) = {"
k
m
E
L
p
m
y
m
y
m
p
L
i
m
k
"}
(10,1,1) = {"
k
m
E
L
m
m
m
y
m
m
m
L
i
w
k
"}
(11,1,1) = {"
R
m
E
L
m
m
m
m
m
m
m
L
i
m
R
"}
(12,1,1) = {"
k
n
E
Z
m
m
m
b
m
m
a
L
i
m
k
"}
(13,1,1) = {"
k
t
E
L
m
m
m
m
m
m
T
L
i
m
k
"}
(14,1,1) = {"
k
m
I
F
F
F
F
F
F
F
F
F
f
m
k
"}
(15,1,1) = {"
k
L
L
G
G
G
G
G
G
G
G
G
L
L
k
"}
(16,1,1) = {"
k
L
m
m
m
m
m
m
m
m
t
m
m
M
k
"}
(17,1,1) = {"
k
k
k
k
k
k
R
k
R
k
k
k
k
k
k
"}
